WWWWWWWWWWWWWWWWWWWWWWWW
WOOOOOOOOOOOOOOOOOOOOOOW
WOSSKSSOSSOSSOSSOSSOSSKW
WOOOOOOOOOOOOOOOOOOOOOOW
WOOOOOOOOOOOOOOOOOOOOOOW
WOSSOSSOSSOSSOSSOSSOSSOW
WOOOOOOOOOOOOOOOOOOOOOOW
WOOOOOOOOOOOOOOOOOOOOOOW
WOSSOSSOSSOSSOSSOSSOSSOW
WOOOOOOOOOOOOOOOOOOOOOOW
AOOOOOOOOOKOOOOOOOOOOOOA
WOSSOSSOSSOSSOSSOSSOSSOW
WOOOOOOOOOOOOOOOOOOOOOOW
WOOOOOOOOOOOOOOOOOOOOOOW
WOSSOSSOSSOSSOSSOSSOSSOW
WOOOOOOOOOOOOOOOOOOOOOOW
WOOOOOKOOOOOOOOOOOOKOOOW
WOSSOSSOSSOSSOSSOSSOSSOW
WOOOOOOOOOOOOOOOOOOOOOOW
WWWWWWWWWWEWWWWWWWWWWWWW